+-+-+-+-+-+-+-+-+-+-+
|                   |
+                   +
|                   |
+                   +
|                   |
+                   +
|                   |
+                   +
|         S         |
+                   +
|                   |
+                   +
|                   |
+                   +
|                   |
+                   +
|         E         |
+                   +
|                   |
+-+-+-+-+-+-+-+-+-+-+
