+-+-+-+-+-+-+---+---+
|   |   |   |   |   E
+ | | | | | | | | | +
| | | | | | | | | | |
+ | | | | | | | | | +
S | | | | | | | | | |
+ | | | | | | | | | +
| | | | | | | | | | |
+ | | | | | | | | | +
| | | | | | | | | | |
+ | | | | | | | | | +
| | | | | | | | | | |
+ | | | | | | | | | +
| | | | | | | | | | |
+ | | | | | | | | | +
| | | | | | | | | | |
+ | | |   | | | | | +
| |   |   |   |   | |
+ +---+---+---+---+ +
|                   |
+-+-+-+-+-+-+-+-+-+-+
