+-+-+-+-+-+-+-+-+-+-+
S   |       |   |   |
+ + + +-+ + + + + + +
| | |   | | | | | | |
+ +-+-+ + + + + + + +
|       | | | |   | |
+-+-+ +-+ + + +-+ + +
|   | |   | | |   | |
+ + + + +-+ + + +-+-+
| |   |   | | |     |
+-+-+ +-+ + + +-+-+ +
|   | |   | | |   | |
+ + +-+ +-+-+ + +-+ +
| | |   |     |     |
+ + + +-+ +-+ + +-+-+
| | | |     | |     |
+ + + + +-+-+ +-+-+-+
| |   | |     |     |
+ +-+-+ + +-+-+ +-+ +
|       |       |   E
+-+-+-+-+-+-+-+-+-+-+
