+-+-+-+-+-+-+-+-+-+-+
S                   |
+                   +
|                   |
+                   +
|                   |
+                   +
|                   |
+                   +
|                   |
+                   +
|                   |
+                   +
|                   |
+                   +
|                   |
+                   +
|                   |
+                   +
|                   E
+-+-+-+-+-+-+-+-+-+-+
